################
#        #     #
#        #     #
#        #     #
#        #     #
#              #
#           #  #
#    ##     #  #
#    #      #  #
#    #      #  #
#    #  #   #  #
################