                
         #     #
         #     #
         #     #
         #     #
               #
            #  #
     ##     #  #
     #      #  #
     #      #  #
     #  #   #  #
                